Boost Practice=Rookie Quests
Coin Pouch=Effort Payback
Test Your Might=Hills' Giant
Beekeeper=Honey
Coin Purse=Giant Slayer
Gaius Confrontation=Souls Flask
Random Encounter=Soul Gatherer
The Winner Takes All=Novice Quests
Worm Nest=Worm Jelly Potion
Wasps Domination=Guardian Angel
Clearing The Skies=Blessing of Hades
Coin Hunt=Collectables Magnet
The Thrill Of One More Kill=Beginner Quests
Worm Domination=Soul Splitter
Bat Hunter=Alpha Worms
Coin Pursuit=Blessed Purse
Enraged Wasps=Hornets
Sweet Vengeance=Red Honey
The Last One To Fall=Advanced Quests
Worm Slaughter=Need For Kill
Demon Eye=Black Secret Potion
Fungus Feast=Cooked Mushrooms
Hand Stingers=Ambidextrous
Ice & Snow=Blue Secret Potion
Never Sacrifice The Will=Graduated Quests
Sticky Compound=Green Secret Potion
Sweet Compound=Yellow Secret Potion
Worm Extinctor=Evil Golden Blood
Archaeologist=Rubysweeper
Coins For Charity=Deflation
Dangerous Annelids=Beta Worms
Goblin Diplomacy=Bonus Gems
Mushroom Smash=Poison Mushrooms
That Tree Just Moved!=Pro Quests
The Key to Success=Chest Hunt Key
Dark Honey=Black Hornets
Demon Souls=Black Demons
Eat Your Veggies=Veggie Box
Hot Souls=Fire Spirits
Last Effort=Expert Quests
Morris=Worm Skin
Soul Carriers=Soul Hobgoblin
Your Superior=Adult Yeti
Juicy Fruits=Fruit Box
King's Favourite=Master Quests
Money Talks=Mystic Purse
Slaying For Fun=Flipping
That's Not A Ruby!=Red Jelly
Yeti Mayhem=Bone Rib Whistle
Bad Weed=Venus Carniplant
Blue Spectre=Blue Wildfires
Chemical Components=Warming Up
Chopping Wood=Carpenter
Divination=Divination
Goblin Escalation=Soul Goblin Chief
Jewel Collector=Shiny Blue
Legacy of The Throne=Royal Quests
Worm Slaughter 2=Blood Merchant
Climate Control=Clean Air
Cold Blooded=Global Quests
Fool's Gold=Sorcerous Purse
Green Sparkle=Emerald Finder
Herblore Master=Potions Seller
Hot Top Volcano=Gamma Worms
Military Souls=Phantoms Aura
Weak Spot Research=That's a lot of damage
Golden Idol=Golden Cobras
Hidden In The Bushes=Berry Pouch
Killing In The Name=Hard Quests
Random Hunter=Belt of Evolution
Sapphire Dust=Golden Diamond
Shiny Hunt=Shiny Charm
The Dark Knight=Fire Bats
Chopping Gold=Golden Oak
Coin Transmutation=Golden Cloth
Devote Your Heart=Zeke’s Disgrace
Electromagnetic=Strong Magnet
Frostbite=Enhanced Soul Grabber
Fury of The Storm=Internal Fury
Order and Progress=Merchant Quests
Secrets of Anhur=Crystal of Anhur
Secrets of Montu=Crystal of Montu
Silver Research=Adamantium
Villager's Currency=Diamonds
Armory Build Up=Extreme Quests
Explorer=Plant Fossil
Face Mask=Poisonous Gases
Free Market=Fish Fossil
Mt. Moon Research=Ammonite Fossil
Mushroom Harvest=Blue Milk Mushrooms
Scorching Flames=Ashes of Ariandel
Shattered Souls=Trapped Forever
Bad Luck=Pandora's Box
Disastrous Attacks=The Rumbling
Easy Come Easy Go=Legendary Purse
Golden Pollination=Golden Nectar
Hornet Ritual=Dark Hornets
Hyper Mode=Hyper Quests
Slaying To Slay More=Enemy Nests
Thick Blood=Blue Jellies
You Can (Not) Be Idle=Longinus' Masterpiece
Inside of Them=Inner Rewards
Vampire Slayer=Giants Overkill
Black Rider=Lucky Horseshoe
Hope of The New Frontier=Souls Ointment
Get Rhythm=Galaxy Quests
From The Void=Dark Matter
Consolation Prize=Coins Overflow
Rock Smash=Jade Hills' Giants
Chemical Plant Zone=Large Soul Barrels
Dissecting=Crystal of Osiris
Loot Hero=An Ace Up My Sleeve
Curiosity=Spacial Shard
The Mysterious Ring=Soul Amplifier Ring
Let's Get Ready to Rumble=Combat Quests
Knight of Gods=Blessing of Apollo
Funk Research=Stellar Energy
Jade Testings=Finally Silverium
Altered Bonus=Rise From Your Grave
Green Switch=Metal Scorpions
Loaded Backpack=Materialization
Break Stuff=Broken Earrings
Oak Farming=Cursed Willow Tree
Demon Slayer=Corrupted Demon
Black Doom's Blood=Serotonin Potion
Death From Above=Dopamine Potion
Giants Mutilation=Big Arrow
Slow Killing Strategy=Ashes of Shadow Sword
Dark Past=Dark Quests: Unlock new Quests.
The Crystal Shards=Crystal Funklouds
Abstract Quests=Abstract Quests
Dark Blizzard=Dark Ice Wraiths
Party Dude!=Wererats
Oh! Banana=Giant Gorillas
It's About Family=Charged Adult Yetis
Whirlwind Warrior=Advanced Wind Dash
Coin Flip Fortune=Chronostasis
Chest Hunter's Hoard=Zeal Potion
Giant Slayer Saga=Strange Eye
Berserker's Bounty=Hostility Potion
Through the Fire and Flames=Elegant Quests
Gleaming Gladiator=Shiny Stone
Wrath of Anubis=Anubis Guardians
Turbo Trigger Trailblazer=Executioner of Greed
Sky Scourge Scramble=Golden Orb
Anna's Assault Apex=Ancient Dagger
Do a Barrel Roll!=Elder Star
Sharpening Gear=Critical Scimitar
Financial Surplus=Souls Tank
Reach for the Stars=Shinobi Slayer
Box Hunt=Divine Quests
Goblins Raid=Soul Goblin Generals
Exorcist=Dark Archdemons
Ape Escape=Astral Quests
Material Girl=Gray Secret Potion
Fatal Fury=Pink Secret Potion
The Force Awakens=White Secret Potion
Minita's Vengeance=Orange Secret Potion
Shiny Happy People=Red Secret Potion
My Precious=Exclusive Quests
Idle Climber=Amauti
Disposable Heroes=Reinforced Hammer
Song of Storms=Golden Star Notes
Shine Bright Like a Diamond=Essence of Zynium
Top Brass Slayer=Path to the Loot
Weapons of War=Treasure Surge
Target Shooting=Soul Capture
Show Yourself=Frozen Spirits
Sanguine Giants=Veins of Power
Precision Strike=Lethal Attack
Acceleration Overdrive=World Record in Running
Fungicide=Inky Cap Mushrooms
Box Hunt=Belt of Agnis
Cobra Venom=Deadly Slash
Toxin Study=Purple Secret Potion
Warrior Awakening=Anubis Warrior
And One More Thing=Joey’s Amulet
Biotechnology=Dragon Mushrooms
Joey's Advice=Critical Mushrooms
Joey's Hint=Extravagant Mushrooms
Dashing Wind=Higgins' Amulet
The Eternal Flame=Rabadon's Deathcap
The Legendary Tree=Legendary Leaf
The Sacred Herbs=Chlorophyll Potion
What One Does For Love=Charged Yeti's Head